7 9 2

222222222
111111122
222212222
221112222
133111111
321111222
011111111