9 10 1
1111111111
2222212222
1111111111
1111111111
3222222111
1111112111
1222222111
1111111111
1111011111