10 10 1
1111111111
1111111111
2222212222
1111111111
2111111111
3222222111
1111111111
1222022111
1111111111
1111011111